I interviewed for a Business Analyst position - я проходил собеседование на должность бизнес-аналитика
CIO (Chief Information Officer) - Директор по информационным технологиям/ИТ-директор
multi-national software development firm - многонациональная фирма по разработке программного обеспечения
in charge of the company's worldwide IT operations - отвечает за ИТ-операции компании по всему миру
offshore development projects - проекты оффшорного (дистанционного) программирования!
current trends within the IT service sector - текущие тенденции в секторе IT-услуг
evaluation - оценка
whether it was technical or business skills - будь то технические или деловые навыки
summed up his advice - резюмировал свой совет
industry - отрасль
reasoning - аргументация 
not easily be obtained - нелегко найти(получить) 
He went on to say - Далее он сказал
conceded - признал
although - несмотря на то что (хотя)
certainly - безусловно
His comments are consistent with - Его комментарии согласуются с 
US-based programmers - Программисты из США
growing view - всё более популярное мнение (распростряющееся мнение)
commodity skill - "товарный навык"
fraction of what I make - малую часть того, что я зарабатываю
reaffirm - подтвердить
subtle - тонкий
major - наиболее важный, главный
shift - сдвиг, изменение, смена
labor market - рынок труда
I gave weight to his viewpoint - Я поддержал его точку зрения
trendsetters of the technology industry - законодатели тенденций в индустрии высоких технологий 
set the directives for a company's IT needs - устанавливают IT-потребности компании 
requirements desired for the higher-paying positions. - требования, предъявляемые к высокооплачиваемым должностям.
US Bureau of Labor Statistics Occupational Outlook Handbook - Справочник по профессиональным прогнозам Бюро статистики труда США
occupations - профессии
Handbook - Справочник
devise ways - разрабатывать (изобретать) способы
separately - отдельно
astounding - поразительный 
up from / down from  - начиная с
also states - также говорится
employment - трудоустройство 
estimates - оценки 
the number of jobs being offshored - количество переводимых рабочих мест в офшоры 
full-time job - работа на полную ставку
хорошие перспективы трудоустройства - хорошие перспективы трудоустройства 
it seems - по-видимому
overnight - сразу, в одночасье
Making the Shift - (Карьерный рост?)
on-the-job - на рабочем месте
responsibility - обязанность
throughout the project (I was on ) - на протяжении всего проекта (над которым я работал)
things proved - все оказалось
too overwhelming - слишком непреодолимым
for my superiors - для моего начальства
gradually - постепенно 
when the opportunity presented itself - когда представилась возможность
accounting - бухгалтерия
enhancement - усовершенствование
It wasn't long before - вскоре
ultimately - в конечном счете 
fulfill - выполнить, удовлетворить
demand - потребность 
positions - ... вакансии